MARCOURT Jean-Claude	PS
DE KEYSER Veronique	PS
VIENNE Christiane	PS
MORIAU Patrick	PS
DAERDEN Frederic	PS
DEOM Valerie	PS
LAANAN Fadila	PS
COURARD Philippe	PS
DELVAUX Anne	CDH
DI ANTONIO Carlo	CDH
MATZ Vanessa	CDH
MIGISHA Pierre	CDH
MOINNET-JOIRET Isabelle	CDH
MEQOR Amal	CDH
LECLERCQ Michel	CDH
VISEUR Jean-Jacques	CDH
MICHEL Louis	MR
RIES Frederique	MR
CHASTEL Olivier	MR
ATTAR Rachida	MR
THIERY Damien	MR
MATHIEU Sophie	MR
GOL-LESCOT Carine	MR
MONFILS Philippe	MR
DURANT Isabelle	ECOLO
LAMBERTS Philippe	ECOLO
IHIRROU Zaina	ECOLO
LECH Bartosz	ECOLO
KUMANOVA Nermin	ECOLO
PETERS Andre	ECOLO
THIBAUT Cecile	ECOLO
MORAEL Jacky	ECOLO
GENDEBIEN Paul-Henry	R.W.F
NASTASI Agath	R.W.F
BROGNIET Laurent	R.W.F
DEHAYBE Liliane	R.W.F
IZQUIERDO-PRIETO Eve	R.W.F
STAQUET Jean-Pol	R.W.F
THIRY Lise	R.W.F
SWENNEN Rene	R.W.F
BORBOUSE Jean-Pierre	FN
SESSLER Jeannine	FN
SESSLER Patrick	FN
OUSSATOFF Anne	FN
de LAUNOIS Quentin	FN
BEUDOT Brigitte	FN
DUQUENNE Philippe	FN
MATAGNE Florence	FN
HEDEBOUW Raoul	PTB+
MERCKX Sofie	PTB+
VAN HEES Marco	PTB+
MOSCUFO Nadia	PTB+
PESTIEAU David	PTB+
IOANNIDIS Fotoula	PTB+
GERAETS Claire	PTB+
FERMON Jan	PTB+
VAN BREMPT Kathleen	SPA
EL KHADRAOUI Said	SPA
VAN LANCKER Anne	SPA
KOCAK Selahattin	SPA
GERMONPRE Tom	SPA
BALTHAZAR Tom	SPA
EL ABOUZI Laila	SPA
VANLERBERGHE Myriam	SPA
VANDENHOVE Ludwig	SPA
UGURLU Sener	SPA
DOUIFI Dalila	SPA
VAN BROECKHOVEN Christine	SPA
ANCIAUX Bert	SPA
MAES Nelly	SLP
LEYS Thomas	SLP
BIDANIA IBARGUTXI Eva	SLP
DECOCK Geert	SLP
AB IAGO Dafydd	SLP
GROFFILS Liesbet	SLP
POSTHUMUS Sybren	SLP
VERBIEST Kathleen	SLP
DEMAN Kristof	SLP
SUTTELS Noel	SLP
STURTEWAGEN Maaike	SLP
BREPOELS Frieda	NVA
VAN NOPPEN Flor	NVA
SLEURS Elke	NVA
IDE Louis	NVA
D'HAESE Hil	NVA
DE NIJN Bart	NVA
CAPOEN An	NVA
HAMBLOK Fons	NVA
FERHO-BAGUIROVA Izoida	NVA
BAUWENS Bart	NVA
CHARLIER Annemie	NVA
BOURGEOIS Geert	NVA
DE WEVER Bart	NVA
STAES Bart	GROEN!
VAN DE PUTTE Joke	GROEN!
ALMACI Meyrem	GROEN!
VAN DIENDEREN Hugo	GROEN!
TAVERNIER Maarten	GROEN!
JELLEMA Rik	GROEN!
MATTHIEU Sara	GROEN!
DE PRINS Francine	GROEN!
ASLIYUCE Inan	GROEN!
AVIJN Philippe	GROEN!
KESTENS Tom	GROEN!
VAN DER STRAETEN Tinne	GROEN!
DUA Vera	GROEN!
VANHECKE Frank	VLAAMS BELANG
DILLEN Marijke	VLAAMS BELANG
CLAEYS Philip	VLAAMS BELANG
VISSERS Linda	VLAAMS BELANG
VAN DEN EYNDE Francis	VLAAMS BELANG
DEMOL Johan	VLAAMS BELANG
COLEN Alexandra	VLAAMS BELANG
VAN STEENBERGE Gerda	VLAAMS BELANG
LAEREMANS Bart	VLAAMS BELANG
VALKENIERS Bruno	VLAAMS BELANG
DEHAENE Jean-Luc	CD&V
THYSSEN Marianne	CD&V
BELET Ivo	CD&V
BOONS Van GOOL Nik	CD&V
STIJNEN Francis	CD&V
NAGELS Anniek	CD&V
UZUN Mustafa	CD&V
PILET Anja	CD&V
MILLECAMPS Luc	CD&V
VERHENNE Franceska	CD&V
VERHOFSTADT Guy	OpenVLD
NEYTS-UYTTERBROEK Annemie	OpenVLD
STERCKX Dirk	OpenVLD
VAUTMANS Hilde	OpenVLD
DE RIDDER Annick	OpenVLD
BROCATUS Davy	OpenVLD
LESAFFRE Martine	OpenVLD
DE PADT Caroline	OpenVLD
DE CROO Alexander	OpenVLD
HERMANS Margriet	OpenVLD